s s s s s s s s s g s s s s s s s s s s
s s s s s s g s s s s g s s s g s s s s
s s s s s g s g s g s s s s s s s s s s
s s s g g s g s s s s s s s s s s s s s
s s s s g s s s s s s s s s s s s s s s
s s s s s g s s s s s s s s s s s s s s
s s s s s s s s s s s s s s s s s s s s
s s s s bs s s s s s s s s s s s s s s s
s s s m r r r m m m r r r r r r r st s s
s s s r s s g g g s s s g s bg g s s s s
s s s r s s g s bs g s s g s g s s s s s
s s s r s s s s s s s s s g s s g s s s
s s s r s r r r r r m r g r r r r e s s
s s s r bs r s s g s bs r r m s g g s s s
s s s r m m s s g s s g s s s g s g s s
s s s s s s s s s g s s s s s g s s s s
s s s s s s s g s s s s s s s s s s s s
s s s s s s g s s g s s g s s g s s s s
s s s s s s g s g s s s s g s g s s s s
s s s s s s s s s g s s s s s s s s s s