s s g s s g g g g g g g g g g g g g g g
s s s g s g g g g g g g g g g g g g g g
g s s s g g g g g g g g g g g g g g g g
s s s s g g g g g g g g s r r r e g g g
g s s g g r r r m m g bs g r s g g g g s
g s g g g r g g g m g g s r g s g g g s
s g g g g r g bg g m g g g r g g g s s g
g s g g g m g g g r r r r r g g s s s s
s s g g g m g g g g g g g s g g g s s g
s s g g g r r r r r r r s g s g g g g s
s g g g g s g bs g g g r ba s s g g g g g
s g g r r r r m m m g r s g s g s g g g
g g g r bg g g s g m g r g g g s s g g g
g g r r g s g s g r g r g g g g s g g g
g g r g g g s g g r r r g g g g g g g g
g g st g g g g g g g g g g g g g g g s g
g g g g g g g g g g g g g g g g g g s g
g g g g g g g g g g g g g g s g s s g s
g g g g g g g g g g g g g s g s s s s s
g g g g g g g g g g g g g g s g s s s s