g g g g g g g g g g g g g g g g g g g g
g g g g g g g g g g g s s g g g g g g g
g g g g g g bg g g g g bs g g g g g g g g
g g g st m m m m m r r r g g g g g g g g
g g g g g g bg g bg g g r s s s g g g g g
g g g g g g g r r r r r s bs g s g g g g
g g g g g g g r g g bs s g g g g g g g g
g g g g g g g r r r r m m m r r e g g g
g g g g g g g g bs s g g s g g g g g g g
g g g g g g g s s g s s g g g g g g g g
g g g g g g s s s s s s s s g g g g g g
g g g g g s s s s s s g s s s s g g g g
g g g g s s s s g g s s g g g g g g g g
g g g g s s s s g g s s g g g g g g g g
g g g g g s s s s s s g g s s s g g g g
g g g g g g s s s s g g g g s g g g g g
g g g g g g g s s g g g g g g g g g g g
g g g g g g g g g g g g g g g g g g g g
g g g g g g g g g g g g g g g g g g g g
g g g g g g g g g g g g g g g g g g g g